XXXXXXXXXXXXXXXXXXXXXXXXXXXXXXXXXXX
X1231231231312313123X3121121X23212X
X1a22X131232X1X31231X3231132X21X23X
X1123X21311231XXXXXXX1322311Xb3X12X
XXXXXX22113131323211X3321131XX2X31X
X1231323X13112XX2X1X332112312XXX2XX
X2312132X11XX1231XX12XXXXXXXX31123X
X123XXXXX31231231X312X12312XX23132X
X31XX31dX331123213122X23c11XXX3123X
X1211231X312312312312X123123XX3312X
XXXXXXXXXXXXXXXXXXXXXXXXXXXXXXXXXXX